name:Pista4
description:Pista sencilla
GGGGGGGGGGGGGGGGGGGGGGGGGWW
GGGGGGGGGGGGGGGGGGGGGGGGGWW
GGWWWWWWWWWWWWWWWWWWWWWGGWW
GGWWWWWWWWWWWWWWWWWWWWWGGWW
GGWWTTTTTTTTTTTTTTTTTWWGGWW
GGWWTTTTTTTTTTTTTTTTTWWGGWW
GGWWTTTTTTTTTTTTTTTTTWWGGWW
GGWWTTTTTTTTTTTTTTTTTWWGGWW
GGWWTTTTWWWWWWWWWTTTTWWGGWW
GGWWTTTTWWWWWWWWWTTTTWWGGWW
GGWWTTTTWWGGGGGWWTTTTWWGGWW
GGWWTTTTWWGGGGGWWTTTTWWGGWW
GGWWFFFFWWGGGGGWWTTTTWWGGWW
GGWWFFFFWWGGGGGWWTTTTWWGGWW
GGWWTTTTWWGGGGGWWTTTTWWGGWW
GGWWTTTTWWWWWWWWWTTTTWWGGWW
GGWWTTTTWWWWWWWWWTTTTWWGGWW
GGWWTTTTTTTTTTTTTTTTTWWGGWW
GGWWTTTTTTTTTTTTTTTTTWWGGWW
GGWWTTTTTTTTTTTTTTTTTWWGGWW
GGWWTTTTTTTTTTTTTTTTTWWGGWW
GGWWWWWWWWWWWWWWWWWWWWWGGWW
GGWWWWWWWWWWWWWWWWWWWWWGGWW
GGGGGGGGGGGGGGGGGGGGGGGGGWW
GGGGGGGGGGGGGGGGGGGGGGGGGWW
checkpoints
3:12:6:2
12:3:1:6
16:12:6:1
12:16:1:6