name:Pista1
description:Pista sencilla
GGGGGGGGGGGGGGGGGGGGGGGGG
GWWWWWWWWWWWWWWWWWWWWWWWG
GWGGGGGGGGGGGGGGGGGGGGGWG
GWGBBBBBBBBBBBBBBBBBBBGWG
GWGBTTTTTTTTTTTTTTTTTBGWG
GWGBTTTTTTTTTTTTTTTTTBGWG
GWGBTTTTTTTTTTTTTTTTTBGWG
GWGBTTTTTTTTTTTTTTTTTBGWG
GWGBTTTTBBBBBBBBBTTTTBGWG
GWGBTTTTBGGGGGGGBTTTTBGWG
GWGBTTTTBGWWWWWGBTTTTBGWG
GWGBTTTTBGWGGGWGBTTTTBGWG
GWGBFFFFBGWGGGWGBTTTTBGWG
GWGBFFFFBGWGGGWGBTTTTBGWG
GWGBTTTTBGWWWWWGBTTTTBGWG
GWGBTTTTBGGGGGGGBTTTTBGWG
GWGBTTTTBBBBBBBBBTTTTBGWG
GWGBTTTTTTTTTTTTTTTTTBGWG
GWGBTTTTTTTTTTTTTTTTTBGWG
GWGBTTTTTTTTTTTTTTTTTBGWG
GWGBTTTTTTTTTTTTTTTTTBGWG
GWGBBBBBBBBBBBBBBBBBBBGWG
GWGGGGGGGGGGGGGGGGGGGGGWG
GWWWWWWWWWWWWWWWWWWWWWWWG
GGGGGGGGGGGGGGGGGGGGGGGGG