name:Pista5
description:Pista imposible
WWWWWWWWWWWWWWWGGGGGGGGGG
WTTTTTTTCTTTTTWGGGGGGGGGG
WTTTTTTTCTTTTTWGGGGGGGGGG
WTTWWWWWWWWWTTWWWWWWWWGGG
WTTWGGGGGGGWTTTTTTTTTWGGG
WTTWWWWGGGGWTTTTTTTTTWWWG
WTTTTTWGGGGWWWWWWWWTTTTWG
WTTTTTWGGGGGGGGGGGWTTTTWG
WWWWTTWGGGGGGGGGGGWWWTTWG
GGGWTTWGGGGGGGGGGGGGWTTWG
GWWWTTWGGGGGGGGGGGGGWTTWG
GWTTTTWGGGGGGGGGGGGGWCCWG
GWTTTTWGGGGGGGGGGGGGWTTWG
GWTTWWWGGGGGGGGGGGGGWTTWG
GWTTWGGGGGGGGGGGGGGGWTTWG
GWFFWGGGGGGGGGGGGGGGWTTWG
GWFFWGGGGGGGGGGGGGGGWTTWG
GWTTWGGGGGGGGGGGGGGGWTTWG
GWTTWGGGGGGGGGGGGGGGWTTWG
GWTTWWWWWWWWWWWWWWWWWTTWG
GWTTTTTTTTTTCTTTTTTTTTTWG
GWTTTTTTTTTTCTTTTTTTTTTWG
GWWWWWWWWWWWWWWWWWWWWWWWG
GGGGGGGGGGGGGGGGGGGGGGGGG
GGGGGGGGGGGGGGGGGGGGGGGGG
checkpoints
3:15:2:2
9:1:1:2
22:11:2:1
13:20:1:2