name:Pista5
description:Impossible
WWWWWWWWWWWWWWWGGGGGGGGGG
WTTTTTBTCTBTTTWGGGGGGGGGG
WTTTTTBTCTBTTTWGGGGGGGGGG
WTTWWWWWWWWWTTWWWWWWWWGGG
WTTWGGGGGGGWTTTTTTTTTWGGG
WTTWWWWGGGGWTTTTTTTTTWWWG
WTTTTTWGGGGWWWWWWWWTTTTWG
WTTTTTWGGGGGGGGGGGWTTTTWG
WWWWTTWGGGGGGGGGGGWWWTTWG
GGGWTTWGGGGGGGGGGGGGWBBWG
GWWWTTWGGGGGGGGGGGGGWTTWG
GWTTTTWGGGGGGGGGGGGGWCCWG
GWTTTTWGGGGGGGGGGGGGWTTWG
GWTTWWWGGGGGGGGGGGGGWBBWG
GWTTWGGGGGGGGGGGGGGGWTTWG
GWFFWGGGGGGGGGGGGGGGWTTWG
GWFFWGGGGGGGGGGGGGGGWTTWG
GWTTWGGGGGGGGGGGGGGGWTTWG
GWTTWGGGGGGGGGGGGGGGWTTWG
GWTTWWWWWWWWWWWWWWWWWTTWG
GWTTTTTTTTBTCTBTTTTTTTTWG
GWTTTTTTTTBTCTBTTTTTTTTWG
GWWWWWWWWWWWWWWWWWWWWWWWG
GGGGGGGGGGGGGGGGGGGGGGGGG
GGGGGGGGGGGGGGGGGGGGGGGGG
checkpoints
2:15:2:2
8:1:1:2
22:11:2:1
13:20:1:2