name:Pista1
description:Pista sencilla
GGGGGGGGGGGGGGGGGGGGGGGGG
GWWWWWWWWWWWWWWWWWWWWWWWG
GWGGGGGGGGGGGGGGGGGGGGGWG
GWGBBBBBBBBBCBBBBBBBBBGWG
GWGBTTTTTTTTCTTTTTTTTBGWG
GWGBTTTTTTTTCTTTTTTTTBGWG
GWGBTTTTTTTTCTTTTTTTTBGWG
GWGBTTTTTTTTCTTTTTTTTBGWG
GWGBTTTTBBBBCBBBBTTTTBGWG
GWGBTTTTBGGGGGGGBTTTTBGWG
GWGBTTTTBGWWWWWGBTTTTBGWG
GWGBTTTTBGWGGGWGBTTTTBGWG
GWGFFFFFFGWGGGWGCCCCCCGWG
GWGFFFFFFGWGGGWGBTTTTBGWG
GWGBTTTTBGWWWWWGBTTTTBGWG
GWGBTTTTBGGGGGGGBTTTTBGWG
GWGBTTTTBBBBCBBBBTTTTBGWG
GWGBTTTTTTTTCTTTTTTTTBGWG
GWGBTTTTTTTTCTTTTTTTTBGWG
GWGBTTTTTTTTCTTTTTTTTBGWG
GWGBTTTTTTTTCTTTTTTTTBGWG
GWGBBBBBBBBBCBBBBBBBBBGWG
GWGGGGGGGGGGGGGGGGGGGGGWG
GWWWWWWWWWWWWWWWWWWWWWWWG
GGGGGGGGGGGGGGGGGGGGGGGGG
checkpoints
3:12:6:2
12:3:1:6
16:12:6:1
12:16:1:6
