name:Pista3
description:Medium
GGGGGGGGGGGGGGGGGGGGGGGGGGGGGGGGGGGGGGGG
GWWWWWWWWWWWWWWWWWWWWWWWWWWWWWWWWWWWWWGG
GWTTTTTTTTTTTTTTTTTCTTTTTTTTTTTTTTTTTWGG
GWTTTTTTTTTTTTTWWWWWWWWWTTTTTTTTTTTTTWGG
GWTTTTTTTTWWWWWWGGGGGGGWWWWWWWTTTTTTTWGG
GWTTTWWWWWWGGGGGGGGGGGGGGGGGGWWWWWTTTWGG
GWTTTWGGGGGGGGGGGGGGGGGGGGGGGGGGGWTTTWGG
GWTTTWGGGGGGGGGGGGGGGGGGGGGGGGGGGWTTTWGG
GWTTTWGGGGGGGGGGGGGGGGGGGGGGGGGGGWTTTWGG
GWTTTWGGGGGGGGGGGGGGGGGGGGGGGGGGGWTTTWGG
GWTTTWGGGGGGGGGGGGGGGGGGGGGGGGGGGWTTTWGG
GWTTTWGGGGGGGGGGGGGGGGGGGGGGGGGGGWTTTWGG
GWFFFWGWWWWWWWWWWWWWWWWWWWWWWWWWGWTTTWGG
GWFFFWGWBBBBBBBBBBBBBBBBBBBBBBBWGWCCCWGG
GWTTTWGWTTTTTTTTTTTCTTTTTTTTTTTWGWTTTWGG
GWTTTWGWTTTTTTTTTTTCTTTTTTTTTTTWGWTTTWGG
GWTTTWGWTTTTTTTTTTTCTTTTTTTTTTTWGWTTTWGG
GWTTTWGWTTTWWWWWWWWWWWWWWWWWTTTWGWTTTWGG
GWTTTWGWTTTWGGGGGGGGGGGGGGGWTTTWGWTTTWGG
GWTTTWWWTTTWGGGGGGGGGGGGGGGWTTTWWWTTTWGG
GWTTTTTTTTTWGGGGGGGGGGGGGGGWTTTTTTTTTWGG
GWTTTTTTTTTWGGGGGGGGGGGGGGGWTTTTTTTTTWGG
GWTTTTTTTTTWGGGGGGGGGGGGGGGWTTTTTTTTTWGG
GWWWWWWWWWWWGGGGGGGGGGGGGGGWWWWWWWWWWWGG
GGGGGGGGGGGGGGGGGGGGGGGGGGGGGGGGGGGGGGGG
checkpoints
3:12:3:2
20:2:1:1
35:13:3:1
20:14:1:3