name:Pista2
description:Easy
WWWWWWWWWWWWWWWWWWWWWWWWWWWWWWWWWWWWWWWWW
WTTTTTTTTTTTWGGGGGGGGGGGGGGGWTTTTTTTTTTTW
WTTTTTTTTTTTWGGGGGGGGGGGGGGGWTTTTTTTTTTTW
WTTTTTTTTTTTWGGGGGGGGGGGGGGGWTTTTTTTTTTTW
WTTTTTWTTTTTWGGGGGGGGGGGGGGGWTTTTTWTTTTTW
WTTTTTWTTTTTWGGGGGGGGGGGGGGGWTTTTTWTTTTTW
WTTTTTWTTTTTWWWWWWWWWWWWWWWWWTTTTTWTTTTTW
WTTTTTWTTTTTWGGGGGGGGGGGGGGGWTTTTTWTTTTTW
WTTTTTWTTTTTWBBBBBBBBBBBBBBBWTTTTTWTTTTTW
WTTTTTWTTTTTBTTTTBTTTTTBTTTTBTTTTTWTTTTTW
WTTTTTWTTTTTBTTTTBTTTTTBTTTTBTTTTTWTTTTTW
WTTTTTWTTTTTBTTTTBTTTTTBTTTTBTTTTTWTTTTTW
WTTTTTWTTTTTBTTTTBTTTTTBTTTTBTTTTTWTTTTTW
WTTTTTWTTTTTBTTTTBTTTTTBTTTTBTTTTTWTTTTTW
WTTTTTWTTTTTWBBBBBBBBBBBBBBBWTTTTTWTTTTTW
WTTTTTWTTTTTWGGGGGGGGGGGGGGGWTTTTTWTTTTTW
WTTTTTWTTTTTWWWWWWWWWWWWWWWWWTTTTTWTTTTTW
WTTTTTWTTTTTTTTTTTTTTTTTTTTTTTTTTTWTTTTTW
WTTTTTWTTTTTTTTTTTTTTTTTTTTTTTTTTTWTTTTTW
WTTTTTWTTTTTTTTTTTTTTTTTTTTTTTTTTTWTTTTTW
WTTTTTWWWWWWWWWWWWWWWWWWWWWWWWWWWWWTTTTTW
WTTTTTTTTTTTTTTTTTTTFTTTTTTTTTTTTTTTTTTTW
WTTTTTTTTTTTTTTTTTTTFTTTTTTTTTTTTTTTTTTTW
WTTTTTTTTTTTTTTTTTTTFTTTTTTTTTTTTTTTTTTTW
WWWWWWWWWWWWWWWWWWWWWWWWWWWWWWWWWWWWWWWWW
checkpoints
21:21:1:3
7:1:1:3
35:1:1:3