name:Pista3
description:Pista sencilla
GGGGGGGGGGGGGGGGGGGGGGGGG
GGGGGGGGGGGGGGGGGGGGGGGGG
GGWWWWWWWWWWWWWWWWWWWWWGG
GGWWWWWWWWWWWWWWWWWWWWWGG
GGWWTTTTTTTTTTTTTTTTTWWGG
GGWWTTTTTTTTTTTTTTTTTWWGG
GGWWTTTTTTTTTTTTTTTTTWWGG
GGWWTTTTTTTTTTTTTTTTTWWGG
GGWWTTTTWWWWWWWWWTTTTWWGG
GGWWTTTTWWWWWWWWWTTTTWWGG
GGWWTTTTWWGGGGGWWTTTTWWGG
GGWWTTTTWWGGGGGWWTTTTWWGG
GGWWFFFFWWGGGGGWWTTTTWWGG
GGWWFFFFWWGGGGGWWTTTTWWGG
GGWWTTTTWWGGGGGWWTTTTWWGG
GGWWTTTTWWWWWWWWWTTTTWWGG
GGWWTTTTWWWWWWWWWTTTTWWGG
GGWWTTTTTTTTTTTTTTTTTWWGG
GGWWTTTTTTTTTTTTTTTTTWWGG
GGWWTTTTTTTTTTTTTTTTTWWGG
GGWWTTTTTTTTTTTTTTTTTWWGG
GGWWWWWWWWWWWWWWWWWWWWWGG
GGWWWWWWWWWWWWWWWWWWWWWGG
GGGGGGGGGGGGGGGGGGGGGGGGG
GGGGGGGGGGGGGGGGGGGGGGGGG
checkpoints
3:12:6:2
12:3:1:6
16:12:6:1
12:16:1:6