name:Pista4
description:Pista sencilla
GWWWWWWWWWWWWWWWWWWWWWWWWWWWWWWWWWWWWWWG
GWGGGGGGGGGGGGGGGGGGGGGGGGGGGGGGGGGGGGWG
GWGTTTTTTTTTTTTTTTTTTTTTTTTTTTTTTTTTTGWG
GWGTTTTTTTTTTTTTTTTTTTTTTTTTTTTTTTTTTGWG
GWGTTTGGGGGGGGGGGGGGGGGGGGGGGGGGGGTTTGWG
GWGTTTGWWWWWWWWWWWWWWWWWWWWWWWWWWCCCCCWG
GWGTTTGWGGGGGGGGGGGGGGGGGGGGGGGGGGTTTGWG
GWGTTTGWGTTTTTTTTTTTTTTTTTTTTTTTTTTTTGWG
GWGTTTGWGTTTTTTTTTTTTTTTTTTTTTTTTTTTTGWG
GWGTTTGWGTTTTTTTTTTTTTTTTTTTTTTTTTTTTGWG
GWGTTTGWGTTTGGGGGGGGGGGGGGGGGGGGGGGGGGWG
GWGTTTGWCCCCCWWWWWWWWWWWWWWWWWWWWWWWWWWG
GWFFFFFWGTTTGGGGGGGGGGGGGGGGGGGGGGGGGGWG
GWGTTTGWGTTTTTTTTTTTTTTTTTTTTTTTTTTTTGWG
GWGTTTGWGTTTTTTTTTTTTTTTTTTTTTTTTTTTTGWG
GWGTTTGWGTTTTTTTTTTTTTTTTTTTTTTTTTTTTGWG
GWGTTTGWGGGGGGGGGGGGGGGGGGGGGGGGGGTTTGWG
GWGTTTGWWWWWWWWWWWWWWWWWWWWWWWWWWCCCCCWG
GWGTTTGGGGGGGGGGGGGGGGGGGGGGGGGGGGTTTGWG
GWGTTTTTTTTTTTTTTTTTTTTTTTTTTTTTTTTTTGWG
GWGTTTTTTTTTTTTTTTTTTTTTTTTTTTTTTTTTTGWG
GWGTTTTTTTTTTTTTTTTTTTTTTTTTTTTTTTTTTGWG
GWGGGGGGGGGGGGGGGGGGGGGGGGGGGGGGGGGGGGWG
GWWWWWWWWWWWWWWWWWWWWWWWWWWWWWWWWWWWWWWG
GGGGGGGGGGGGGGGGGGGGGGGGGGGGGGGGGGGGGGGG
checkpoints
3:12:5:1
33:5:5:1
8:11:5:1
33:17:5:1