name:Pista5
description:Pista imposible
WWWWWWWWWWWWWWWGGGGGGGGGG
WTTTTTTTTTTTTTWGGGGGGGGGG
WTTTTTTTTTTTTTWGGGGGGGGGG
WTTWWWWWWWWWTTWWWWWWWWGGG
WTTWGGGGGGGWTTTTTTTTTWGGG
WTTWWWWGGGGWTTTTTTTTTWWWG
WTTTTTWGGGGWWWWWWWWTTTTWG
WTTTTTWGGGGGGGGGGGWTTTTWG
WWWWTTWGGGGGGGGGGGWWWTTWG
GGGWTTWGGGGGGGGGGGGGWTTWG
GWWWTTWGGGGGGGGGGGGGWTTWG
GWTTTTWGGGGGGGGGGGGGWTTWG
GWTTTTWGGGGGGGGGGGGGWTTWG
GWTTWWWGGGGGGGGGGGGGWTTWG
GWTTWGGGGGGGGGGGGGGGWTTWG
GWTTWGGGGGGGGGGGGGGGWTTWG
GWTTWGGGGGGGGGGGGGGGWTTWG
GWTTWGGGGGGGGGGGGGGGWTTWG
GWTTWGGGGGGGGGGGGGGGWTTWG
GWTTWWWWWWWWWWWWWWWWWTTWG
GWTTTTTTTTFFTTTTTTTTTTTWG
GWTTTTTTTTFFTTTTTTTTTTTWG
GWWWWWWWWWWWWWWWWWWWWWWWG
GGGGGGGGGGGGGGGGGGGGGGGGG
GGGGGGGGGGGGGGGGGGGGGGGGG
checkpoints
3:12:6:2
12:3:1:6
16:12:6:1
12:16:1:6